1111111111
10EC0P0001
1111111111
